16
16
**+*************
**-*************
**-******------*
**-******-****-*
**----***-**---*
*****-***-**-***
*****-***-**-***
*****-***-**-***
**----***-**---*
**-******-****-*
**-******-****-*
**--------****-*
**************-*
**************-*
**************-*
**************-*