16
13
****************
------**********
*****----*******
********-*******
*--------*******
*-**************
*-----------****
***********-****
***********-****
***********-****
***********-****
***********-----
****************