1121111111111111
1121111111111111
1121111111111111
1122222222221111
1111111111121111
1111111111121111
1111111111121111
1111111111121111